Beijing - Patrick Watson
Quintette à cordes n°3 en Ut Maj K 515 : 2. Menuetto - Trio - Quatuor Ebene & Pierre Colombet & Gabriel Le Magadure & Marie Chilemme & Raphael Merlin
La sitiera - Omara Portuondo
Dmaot - Haziz
She's a rainbow - The Rolling Stones
Float (feat. Seun Kuti & Egypt 80) - Janelle Monae & Seun Kuti & Egypt 80
Rio de nuvens VIII - Cristina Branco & Custodio Castelo & Jorge Fernando & Fernando Maia
Stratus & cumulus - Le Bingo
We are in need - James Bynum
The school boy - David Axelrod
Atlanta kaira - Taj Mahal & Toumani Diabate
Memories don't die - Klim Beats
Out of time - Shawn Lee's Ping Pong Orchestra
Koop Island blues - Koop & Ane Brun
Coume couma - Rubin Steiner & The Dictaphone
La boîte à musique - L
Milestones - Charlie Parker & Divers
Arms & legs - Marvin Pontiac & John Lurie & Tony Scherr & Calvin Weston & Jaime Scott
L'histoire est belle - Yo & The South
Breakdown (Nightmares On Wax mix) - Jack Johnson & Nightmares On Wax
La baie - Etienne Daho
Whatever (strings) - Oasis
Greek song - Rufus Wainwright
The home of Beethoven - Emahoy Tsege Mariam Gebru
Wild imagination - Sweet Baboo & Stephen Black
Can You Imagine - Little Anthony & The Imperials
Coracao sensivel - Dave Brubeck Quartet & Dave Brubeck & Paul Desmond
Call me the breeze - JJ Cale
Karmacoma - Massive Attack
Heat of the moon - Eliza
Arabesque n°1 - Isao Tomita
Castelmaure (radio edit) - Flavien Berger
Madam operator - Madness
Kilamu - Saronde
Mentira - Marcos Valle
Daydreamer - Patrick Watson
Trouble with dreams - Eels
Bringing It Down - The Peppers
Problem child - Ben Harper
Just let him know you love him - Julia Werup
Let's start all over again - Syl Johnson
Odessa - Caribou
Light up your life (broken mix) - The Rhythm Slaves
Thank U - Alanis Morissette
See ya there - Genesis Owusu
Look - Sebastien Tellier
Hard knock life (ghetto anthem) - Jay-Z
I won't let you down - Curtis Harding
Blisters - The James Hunter Six
Red right hand - Nick Cave
Icare - Wouf Wouf
Cupola (e o) - Cero & Shohei Takagi & Yu Arauchi & Tsubasa Hashimoto
Devotion - Fool's Gold
Obsessions 68 - Sophie Makhno & Colin Verdier
Farmhands club - L'Attirail
The valley of the pagans (feat.Beck) - Gorillaz & Beck
Dinner by candlelight (sticky ribs & dirty sprite) (instrumental) - Spoek Mathambo
